XXxxxxXxxXxxxXxxXxxxxxXX
XXOOOOxOOxOOOxOOxOOOOOXX
XXOOOOOOOOOOOOOOOOOOOOXX
XXOOOOOOOOOOOOOOOOXXXXxx
XXOOOOOOOOOOOOOOOOOOOOOO
XXOSOOOOOOOOOOOOOOOOOOOF
XXOOOOOOOOOOOOOOOOOOOOXX
XXOOOOOOOOOOOOOOOOXXXXXX
XXOOOOOOOOOOOOOOOOOOOOXX
XXOOOOOOOOOOOOOOOOOOOOXX
XXOOOOOOOOOOOOOOOOOOOOXX
XXXXXXXXXXXXXXXXXXXXXXXX