XXXxxxxXXXXXXXXXXXXXXXXX
XXXOOOOXXXXXXXXXXXXXXXXX
XXXOOOOXXXOXOXOXXXOOOXXX
XXXOOOOXXXOOOOOXXXOOOXXX                      
XOOOOOXOOOOOOOOOOXOOOOOX                        
XOOOOOxOOOOOOOOOOxOOOOOX
XOOOOOOOOOOOOOOOOOOOOOOX
XOOOOOOOOOOOOOOOOOOOOOOX
XOOOOOXOOOOOOOOOOXOOOOOX
XOOOOOxOOOOOOOOOOxOOOOOX
XOOOOOOOOOOOOOOOOOOOOOOX
XOOOOOOOOOOOOOOOOOOOOOOX
XOOOOOXOOOOOOOOOOXOOOOOX
XOOOOOxOOOOOOOOOOxOOOOOX
XOOOOOOOOOOOOOOOOOOOOOOX    
XOOOOOOOOOOOOOOOOOOOOOOX
XOOOOOOOOOOOOOOOOOOOOOOX
XOOOOOOOOOOOOOOOOOOOOOOX
XXOOOOOOOOOOOOOOOOOOOOOX
XOOOOOOOOOOOOOOOOOOOOOOX
XOOOOOOOOOOOOOOOOOOOOOOX
XOOOOOOOOOOOSOOOOOOOOOOX
XOOOOOOOOOOOOOOOOOOOOOOX
XXXXXXXXXXXXXXXXXXXXXXXX