XXxxxxxxxxxxxxxxxxxxxxXX
XxOOOOOOOOOOOOOOOOOOOOxX
XOOOOEOOOOOOOOOOOOOOOOOX
XOOOOOOOOOOOOOOOOOOOOOOx                      
XOOOOOOOOOOOOOOOOOOOOOOO                       
XOOOOOOOOOOOOOOOOOOOOOO0
XOOOOOOOOOOOOOOOOOOOOOOX
XOOOEOOOOOOOOxxxxxxxxxXX
XOOOOOOOOOOOOOOOOOOOOOxX
XOOOOOOOOOOOOOOOOOOOOOOX
XOOOOOOOOOOOOOOOEOOOOOOX
XOOOOOOOOOOOOOOOOOOOOOOX
XOOOOOOOOOOOOOOOOOOOOOOX
XOOOOOOOEOOOOOOOOOOOOOOX
XOOOOOOOOOOOOOOOOOOOOOOX    
XOOOOOOOOOOOOOOOOOOOOOOX
XXOOOOOOOOOOOOOOOOOOOOOO
XxxxxxxxxxxxxxxxxxOOOXXX
XOOOOOOOOOOOOOOOOOOOOOOX
XOOOOOOOOOOOOOOOOOOOOOOX
XOOOOOOOOOOOOOOOOOOOOOOX
XOSOOOOOOOOOOOOOOOOOOOOX
XOOOOOOOOOOOOOOOOOOOOOXX
XXXXXXXXXXXXXXXXXXXXXXXX