XXXXXXXXXXXXOOOOXXXXXXXXXXXXXX
XXXXOOOOOOOOOOOOOOOOOOOOOXXXXX                            
XXXOSOOOOOOOOOOOOOOOOOOOOOXXXX
XXXOOOOOOOOOOOOOOOOOOOOOOOXXXX 
XXXOOOOOOOOOOOOOOOOOOOOOOOXXXX
XXXOOOOOOOOOOOOOOOOOOOOOOOXXXX
XXXOOOOOOOOOOOOOOOOOOOOOOOXXXX
XXXOOOOOOOOOOOOOOOOOOOOOOOXXXX
XXXOOOOOOOOOOOOOOOOOOOOOOOXXXX
XXXOOOOOOOOOOOOOOOOOOOOOOOXXXX
XXXOOOOOOOOOOOOOOOOOOOOOOOXXXX
XXXOOOOOOOOOOOOOOOOOOOOOOOXXXX
XXXOOOOOOOOOOOOOOOOOOOOOOOXXXX
OOOOOOOOOOOOOOOOOOOOOOOOOOOOOO
OOOOOOOOOOOOOOOOOOOOOOOOOOOOOO
OOOOOOOOOOOOOOOOOOOOOOOOOOOOOO
OOOOOOOOOOOOOOOOOOOOOOOOOOOOOO
XXXOOOOOOOOOOOOOOOOOOOOOOOXXXX                
XXXOOOOOOOOOOOOOOOOOOOOOOOXXXX 
XXXOOOOOOOOOOOOOOOOOOOOOOOXXXX 
XXXOOOOOOOOOOOOOOOOOOOOOOOXXXX
XXXOOOOOOOOOOOOOOOOOOOOOOOXXXX
XXXOOOOOOOOOOOOOOOOOOOOOOOXXXX
XXXOOOOOOOOOOOOOOOOOOOOOOOXXXX
XXXOOOOOOOOOOOOOOOOOOOOOOOXXXX
XXXOOOOOOOOOOOOOOOOOOOOOOOXXXX 
XXXOOOOOOOOOOOOOOOOOOOOOOOXXXX 
XXXOOOOOOOOOOOOOOOOOOOOOOOXXXX  
XXXXOOOOOOOOOOOOOOOOOOOOOXXXXX
XXXXXXXXXXXXOOOOXXXXXXXXXXXXXX