XXXXXXXXXXXXXXXXXXXXXXXXXXXXXX
XXXOOOOOOOOOOOOOOOOOOOOOOOXXXX 
XXOOOOOOOOOOOOOOOOOEOOOOOOOXXX
XXOOOOOEOOOOOOOOOOOOOOOOOOOOOO                        
XXOOOOOOOOOOOOOOOOOOOOOOOOOOOO                         
XXOOOOOOOOOOOOOOOOOOOOOOOOOXXX
XXOOOOOOOOXXXXXXXOOEOOOOOOOXXX
XXOOOOOOOOXXXXXXXOOOOOOOOOOXXX
XXOOOOEOOOXXXXXXXOOOOOOOOOOXXX
XXOOOOOOOOOOOOOOOOOOOOOOOOOXXX 
XXOOOOOOOOOOOOOOOOOOOOOEOOOXXX 
XXOOOOOOOOOOOOOOOOOOOOOOOOOXXX
XXOOOOOOOOOOOOOOOOOOOOOOOOOXXX
XXXOOOOOOOOOOOOOOOOOOOOOOOXXXX
XXXXXXXOOOOOOOOXXXXXXXXXXXXXXX     
XXXXXXXOOOOOOOOOXXXXXXXXXXXXXX
XXXXOOOOOOOOOOOOOOOOOOOOXXXXXX
XXXXOOOOOOOOOOOOOOOOOOOOOXXXXX
XXXOOOOOOOOOOOOOOOOOOOOOOOXXXX
XXXOOOOOOOOOOOOOOOOOOOOSOOXXXX
XXXOOOOOOOOOOOOOOOOOOOOOOOXXXX
XXXOOOOOOOOOOOOOOOOOOOOOOOXXXX
XXXXXXXXXXXXXXXXXXXXXXXXXXXXXX
