XXXXXXXXXXXXXXXXXXXXXXXX
XXXXXXXXXXXXXXXXXXXXXXXX
XXXOOOOXXXOXXXOXXXOOOXXX
XXXOOOOXXXOXXXOXXXOOOXXX                      
XOOOOOXOOOOOOOOOOOXOOOOX                        
XOOOOOxOOOOOOOOOOOxOOOOX
XOOOOOOOOOOOOOOOOOOOOOOX
XOOOOOOOOOOOOOOOOOOOOOOX
XOOOOOXOOOOOOOOOOOXOOOOX
XOOOOOxOOOOOOOOOOOxOOOOX
XOOOOOOOOOOOOOOOOOOOOOOX
XOOOOOOOOOOOOOOOOOOOOOOX
XOOOOOXOOOOOOOOOOOXOOOOX
XOOOOOxOOOOOOOOOOOxOOOOX
XOOOOOOOOOOOOOOOOOOOOOOX    
XOOOOOOOOOOOOOOOOOOOOOOX
XOOOOOOOOOOOOOOOOOOOOOOX
XOOOOOOOOOOOOOOOOOOOOOOX
XXOOOOOOOOOOOOOOOOOOOOOX
XXXXXXXXXXXXXXXXXXOOOXXX
XOOOOOOOOOOOOOOOOOOOOOOX
XOOOOOOOOOOOSOOOOOOOOOOX
XOOOOOOOOOOOOOOOOOOOOOXX
XXXXXXXXXXXXXXXXXXXXXXXX