XxxxXxxxxxXxxxxxxxxxxxxX
XOOOXOOOOOXOOOOOOOOOOOOX
XSOOXOOOOOXOOOOOOOOOOOOX
XOOOXOOOOOXOOOOOOOOOOOOX
XOOOXOOXOOXOOOOOOOOOOOOX
XOOOXOOXOOXOOOxxxxxXOOOX
XOOOXOOXOOXOOOOOOOOXOOOX
XOOOXOOXOOXOOOOOOOOXOOOX
XOOOXOOXOOXOOOOOOOOXOOOX
XOOOXOOXOOxOOOXxxxxxOOOX
XOOOXOOXOOOOOOXOOOOOOOOX
XOOOXOOXOOOOOOXOOOOOOOOX
XOOOXOOxxxXxxxXOOOOXOOOX
XOOOXOOOOOXOOOXOOOOXOOOx
XOOOXOOOOOXOOOXOOOOXOOOO
XOOOXOOXOOxOOOXOOOOXOOOF
XOOOXOOXOOOOOOXOOOOxxxxX
XOOOXOOXOOOOOOXOOOOOOOOX
XOOOXOOXOOOOOOXOOOOOOOOX
XOOOxxxxOOXxxxxOOOxxxxxX
XOOOOOOOOOXOOOOOOOOOOOOX
XOOOOOOOOOXOOOOOOOOOOOOX
XOOOOOOOOOXOOOOOOOOOOOOX
XXXXXXXXXXXXXXXXXXXXXXXX

	