XXxxxxxxxxxxxxxxxxxxxxXX
XxOOOOOOOOOOOOOOOOOOOOxX
XOOOOOOOOOOOOOOOOOOOOOOX
XOOOOOOOOOOOOOOOOOEOOOOx                      
XOOOOOOOOOOOOOOOOOOOOOOO                       
XOOOOOOOOOOOOOOOOOOOOOOF
XOOOOOOOOOOOOOOOOOOOOOOX
XOOOEOOOOOOOOxxxxxxxxxXX
XOOOOOOOOOOOOOOOOOOOOOxX
XOOOOOOOOOOOOOOOOOOOOOOX
XOOOOOOOOOOOOOOOOOEOOOOX
XOOOOOOOOOOOOOOOOOOOOOOX
XOOOOOOOOOOOOOOOOOOOOOOX
XOOOOOEOOOOOOOOOOOOOOOOX
XOOOOOOOOOOOOOOOOOOOOOOX    
XOOOOOOOOOOOOOOOOOOOOOOX
XXOOOOOOOOOOOOOOOOOOOOOX
XxxxxxxxxxxxxxxxxxOOOxxX
XOOOOOOOOOOOOOOOOOOOOOOX
XOOOOOOOOOOOOOOOOOOOOOOX
XOOOOOOOOOOOOOOOOOOOOOOX
XOSOOOOOOOOOOOOOOOOOOOOX
XOOOOOOOOOOOOOOOOOOOOOXX
XXXXXXXXXXXXXXXXXXXXXXXX