XXXXXXXXXXXXXXXXXXXXXXXX
XXXxxxxxxxxxOxxxxxxxxXXX
XXxOOOOOOOOOOOOOOOOOOxXX
XXOOOOOOOOOOOOOOOOOOOOXX
XXOOOOOOOOOOOOOOOOOOOOXX
XXOOOOOOOOOOOOOOOOOOOOXX
XXOOOOOOOOOOOOOOOOOOOOXX
XXOOOOOOOOOOOOOOOOOOOOXX
XXOOOOOOOOOOOOOOOOOOOOXX
xxOOOOOOOOOOOOOOOXXXXXxx
OOOOOOOOOOOOOOOOOOOOOOOO
0SOOOOOOOOOOOOOOOOOOOOOO
XXOOOOOOOOOOOOOOOOOOOOXX
XXOOOOOOOOOOOOOOOXXXXXXX
XXOOOOOOOOOOOOOOOOOOOOXX
XXOOOOOOOOOOOOOOOOOOOOXX
XXOOOOOOOOOOOOOOOOOOOOXX
XXOOOOOOOOOOOOOOOOOOOOXX
XXOOOOOOOOOOOOOOOOOOOOXX
XXOOOOOOOOOOOOOOOOOOOOXX
XXOOOOOOOOOOOOOOOOOOOOXX
XXXOOOOOOOOOOOOOOOOOOXXX
XXXXXXXXXXXOOXXXXXXXXXXX
XXXXXXXXXXXXXXXXXXXXXXXX