XXxxxxXxxXxxxXxxXxxxxxXX
XXOOOOxOOxOOOxOOxOOOOOXX
XXOOOOOOOOOOOOOOOXXXXXXX
XXOOOOOOOOOOOOOOOOOOOOxx
XXOOOOOOOOOOWOOOOOOOOOOO
XXOSOOOOOOOOOOOOOEOOWOOF
XXOOOOOOOOOOOOOOOOOOOOXX
XXOOOOOOOOOOOOOOOXXXXXXX
XXOOOOOOOOOOOOOOOOOOOOXX
XXOOOOOOOOOOOOOOOOOOOOXX
XXOOOOOOOOOOOOOOOOOOOOXX
XXXXXXXXXXXXXXXXXXXXXXXX