XxxxXxxxxxXxxxxxxxxxxxxX
XOOOXOOOOOXOOOOOOOOOOOOX
XSOOXOOEOOXOOOOOOOOWOOOX
XOOOXOOOOOXOOOWOOOOOOOOX
XOOOXOOXOOXOOOOOOOOOOEOX
XOOOXOOXOOXOOOxxxxxXOOOX
XOOOXOOXOOXOOOOOOOOXOOOX
XOOOXOOXOOXOOOOOOOOXOOOX
XOEOXOOXOOXOOOOOOOOXOOOX
XOOOXOOXOOxOOOXxxxxxOOOX
XOOOXOOXOOOOWOXOOOOOOOOX
XOOOXOOXOOOOOOXOWOOOOOOX
XOOOXOOxxxXxxxXOOOOXOOOX
XOOOXOOOOOXOOOXOOOOXOOOx
XOOOXOOEOOXOOOXOOOOXOOOO
XOOOXOOOOOxOOOXOOOOXOOOF
XOOOXWOXOOOOOOXOOOOxxxxX
XOOOXOOXOOOOOOXOOOOOOOOX
XOOOXOOXOOOOOOXOOOOOOOOX
XOOOxxxxOOXxxxxOOOxxxxxX
XOOOOOOOOOXOOOOOOOOOOOOX
XOOOOOOOWOXOOOOOOOOOOOOX
XOOOOOOOOOXOOOOOOOOOOOOX
XXXXXXXXXXXXXXXXXXXXXXXX

	