XXXXXXXXXXXXXXXXXXXXXXXXXXXXXXXXXX
XOOOOOOOOOOOOOOOOOOOOOOOOOOOOOOOOX
XOOOOOOOOOOOOOOOOOOOOOOOOOOOOOOOOX
XOOOOOOOOOOOOOOOOOOOOOOOOOOOOOOOXX
XOOOOOOOOOOOOOOOOOOOOOOOOOOOOOOOX
XOOOOOOOOOOOOOOOOOOOOOOOOOOOOOOOX
XXOOOOSOOOOOOOOOOOOOOOOOOOOOOOOXX
 XOOOOOOOOOOOOOOOOOOOOOOOOOOOOOX
 XOOOOOOOOOOOOOOOOOOOOOOOOOOOOOX
 XXXXXXXXXXXXXXXXXXXXXXXXXXXXXXX