XxxxxxxxxxxxxxxxxxxxxxxX
XOOOOOOOOOOOOOOOOOOOOOOX
FOOOOOOOOOOOOOOOOOOOOOOX
OOOOOOOOOOOOOOOOOOOOOOOX
XOOOOOOOOOOOOOOOOOOOOOOX
XXXXXXXXXXXXXXXXXXXXXXXX